***************
*X*XXXXX*XXXXX*
*X*****X***X*X*
*X*XXX*XXX*X*X*
*X***X***X*X***
*XXXXXXX*X*XXXX
***X*****X*****
XX*X*XXXXXXXXX*
***X*X*******X*
*XXX*X*XXXXXXX*
*X*X*X*****X***
*X*X*X*X*XXX*XX
*X*X***X***X***
*X*X*XXXXX*XXX*
***X*****X***X*